DawnLike\Objects\Floor.png
63 64 64 64 64 64 64 64 64 64 64 64 64 64 64 64 64 64 64 64 65 66
84 85 85 85 85 85 85 85 85 85 85 85 85 85 85 85 85 85 85 85 86 87
84 85 85 85 85 85 85 85 85 85 85 85 85 85 85 85 85 85 85 85 86 87
84 85 85 85 85 85 85 85 85 85 85 85 85 85 85 85 85 85 85 85 86 87
84 85 85 85 85 85 85 85 85 85 85 85 85 85 85 85 85 85 85 85 86 87
84 85 85 85 85 85 85 85 85 85 85 85 85 85 85 85 85 85 85 85 86 87
84 85 85 85 85 85 85 85 85 85 85 85 85 85 85 85 85 85 85 85 86 87
84 85 85 85 85 85 85 85 85 85 85 85 85 85 85 85 85 85 85 85 86 87
84 85 85 85 85 85 85 85 85 85 85 85 85 85 85 85 85 85 85 85 86 87
84 85 85 85 85 85 85 85 85 85 85 85 85 85 85 85 85 85 85 85 86 87
84 85 85 85 85 85 85 85 85 85 85 85 85 85 85 85 85 85 85 85 86 87
84 85 85 85 85 85 85 85 85 85 85 85 85 85 85 85 85 85 85 85 86 87
84 85 85 85 85 85 85 85 85 85 85 85 85 85 85 85 85 85 85 85 86 87
84 85 85 85 85 85 85 85 85 85 85 85 85 85 85 85 85 85 85 85 86 87
105 106 106 106 106 106 106 106 106 106 106 106 106 106 106 106 106 106 106 106 107 108